16 16
1 1 1 1 1 1 2 7 7 7 7 7 7 7 7 7
1 0 0 0 0 0 2 0 8 0 8 0 0 0 0 6
1 1 1 1 1 0 2 0 8 0 8 0 6 0 0 6
6 0 0 0 0 0 2 0 8 0 8 0 6 6 6 6
6 3 3 3 0 0 2 0 0 0 0 0 0 0 0 6
6 3 0 3 0 0 2 0 9 9 9 0 9 9 9 9
6 0 0 0 0 0 2 0 9 0 9 0 9 0 0 0
6 0 0 3 0 0 2 0 9 0 9 0 9 0 0 0
6 0 3 3 0 0 0 0 9 0 9 0 9 0 0 0
6 0 0 0 0 0 4 0 9 0 9 0 9 0 0 0
6 4 4 4 4 4 4 9 9 0 9 0 9 0 0 0
0 0 0 0 0 0 0 0 0 0 9 0 9 0 0 0
0 0 0 0 0 0 0 0 0 0 9 0 9 0 0 0
0 0 0 0 0 0 0 0 0 0 9 0 9 0 0 0
0 0 0 0 0 0 0 0 0 0 9 0 9 0 0 0
0 0 0 0 0 0 0 0 0 0 5 5 5 0 0 0
5
11 11.5 14.5
11 11.5 13.5
11 11.5 12.5
11 11.5 11.5
11 11.5 10.5
-3 Ceiling1
-2 Floor1
1 Bricks_15-128x128
2 Bricks_13-128x128
3 Bricks_16-128x128
4 Bricks_17-128x128
5 Bricks_22-128x128
6 Bricks_21-128x128
7 Bricks_12-128x128
8 Bricks_20-128x128
9 Bricks_01-128x128
11 Enemy5