16 16
1 1 1 1 1 1 2 1 1 0 0 0 0 0 0 0
1 0 0 1 1 1 0 1 1 0 0 0 0 0 0 0
1 0 0 2 1 1 0 2 1 0 0 0 0 0 0 0
1 0 0 3 1 1 0 1 1 0 0 0 0 0 0 0
1 0 0 1 1 1 0 1 1 0 0 0 0 0 0 0
1 0 0 0 0 0 0 2 1 0 0 0 0 0 0 0
1 0 1 2 1 1 1 1 1 0 0 0 0 0 0 0
1 0 1 1 1 1 1 1 1 0 0 0 0 0 0 0
4 0 4 4 4 4 4 0 0 0 0 0 0 0 0 0
4 0 0 0 0 0 4 0 0 0 0 0 0 0 0 0
4 4 4 4 4 4 4 0 0 0 0 0 0 0 0 0
0 0 0 0 0 0 0 0 0 0 0 0 0 0 0 0
0 0 0 0 0 0 0 0 0 0 0 0 0 0 0 0
0 0 0 0 0 0 0 0 0 0 0 0 0 0 0 0
0 0 0 0 0 0 0 0 0 0 0 0 0 0 0 0
0 0 0 0 0 0 0 0 0 0 0 0 0 0 0 0
1 Office_Beige1
2 Office_Beige3
3 Office_Beige2
4 Office_Blue1