16 16
4 4 4 4 4 4 4 4 4 4 4 4 4 4 4 4
4 0 0 0 0 0 0 0 0 0 0 0 0 0 0 4
4 0 2 2 0 2 2 0 0 1 1 0 1 1 0 4
4 0 2 0 0 0 2 0 0 1 0 0 0 1 0 4
4 0 2 2 2 2 2 0 0 1 1 1 1 1 0 4
4 0 0 0 0 0 0 0 0 0 0 0 0 0 0 4
4 0 6 6 0 0 0 0 0 8 8 8 8 8 0 4
4 0 0 6 6 0 0 0 0 0 0 7 0 0 0 4
4 0 0 0 6 6 0 0 0 0 0 7 0 0 0 4
4 0 0 0 0 6 6 0 0 8 8 8 8 8 0 4
4 0 0 0 0 0 0 0 0 0 0 0 0 0 0 4
4 0 5 5 5 5 5 0 0 3 3 3 3 3 0 4
4 0 5 0 0 0 5 0 0 3 0 0 0 3 0 4
4 0 5 5 0 5 5 0 0 3 3 0 3 3 0 4
4 0 0 0 0 0 0 0 0 0 0 0 0 0 0 4
4 4 4 4 4 4 4 4 4 4 4 4 4 4 4 4
1 blue
2 cyan
3 green
4 grey
5 indigo
6 redBricks32x32
7 porthole32x32
8 sandBricks32x32