16 16
1 1 1 1 1 0 0 0 0 0 0 0 0 0 0 0
1 0 0 0 1 0 0 0 0 0 0 0 0 0 0 0
1 0 0 0 1 0 0 0 0 0 0 0 0 0 0 0
1 0 0 0 1 0 0 0 0 0 0 0 0 0 0 0
1 2 0 2 1 0 0 0 0 0 0 0 0 0 0 0
3 0 0 0 4 0 0 0 0 0 0 0 0 0 0 0
3 5 0 6 4 0 0 0 0 0 0 0 0 0 0 0
0 6 0 5 0 0 0 0 0 0 0 0 0 0 0 0
0 7 7 7 0 0 0 0 0 0 0 0 0 0 0 0
0 0 0 0 0 0 0 0 0 0 0 0 0 0 0 0
0 0 0 0 0 0 0 0 0 0 0 0 0 0 0 0
0 0 0 0 0 0 0 0 0 0 0 0 0 0 0 0
0 0 0 0 0 0 0 0 0 0 0 0 0 0 0 0
0 0 0 0 0 0 0 0 0 0 0 0 0 0 0 0
0 0 0 0 0 0 0 0 0 0 0 0 0 0 0 0
0 0 0 0 0 0 0 0 0 0 0 0 0 0 0 0
1 ugly_blue
2 yellow
3 testWall4
4 testWall2
5 ugly_snowball
6 ugly_yellow_black_triangle
7 ugly_pink