32 32
2 2 2 2 3 3 3 3 4 4 4 4 5 5 5 5 7 7 7 7 8 8 8 8 8 8 8 8 8 8 8 8
2 0 0 0 0 0 0 3 0 0 0 0 0 5 0 0 0 0 0 0 8 0 0 0 0 0 0 0 0 0 0 8
2 0 0 2 0 3 0 3 0 4 4 4 0 5 5 0 7 0 7 0 8 0 8 8 8 8 8 8 8 8 0 8
2 0 2 2 0 3 0 3 0 4 0 0 0 5 0 0 7 0 7 0 8 0 0 0 0 0 0 0 0 0 0 8
2 0 0 0 0 3 0 3 4 4 0 4 0 5 5 0 7 7 7 0 8 0 8 8 8 0 0 8 8 8 0 8
2 0 2 2 3 3 0 0 0 0 0 4 0 5 0 0 7 0 7 0 8 0 0 0 0 0 0 0 0 0 0 8
2 0 0 0 0 3 3 3 4 4 0 4 0 5 5 0 7 0 7 0 8 0 8 8 0 0 0 0 8 8 0 8
2 0 2 2 0 0 0 0 0 0 0 4 0 0 0 0 0 0 0 0 8 0 0 0 0 0 0 0 0 0 0 8
2 0 2 0 0 3 0 3 4 4 0 4 5 5 5 0 7 0 7 0 8 0 8 0 0 0 0 0 0 8 0 8
2 0 2 2 0 3 0 0 0 4 0 0 0 0 0 0 7 0 7 0 8 0 0 0 0 0 0 0 0 0 0 8
2 0 2 0 0 3 3 3 0 4 4 0 5 5 5 0 7 7 7 0 8 0 0 0 0 0 0 0 0 0 0 8
2 0 2 2 0 0 0 3 0 0 4 0 5 0 5 0 7 0 7 0 8 0 0 0 8 0 0 8 0 0 0 8
2 0 2 0 0 3 3 3 0 4 4 0 5 0 5 0 7 0 7 0 8 0 0 8 0 0 0 0 8 0 0 8
2 0 2 2 0 3 0 0 0 0 4 0 5 0 5 0 0 0 0 0 8 0 8 0 0 0 0 0 0 8 0 8
2 0 2 0 0 3 3 3 4 4 4 0 5 0 5 0 7 7 7 0 8 0 8 0 0 0 0 0 0 8 0 8
2 0 2 0 0 0 0 0 0 0 0 0 0 0 5 0 0 7 0 0 8 0 0 0 0 8 8 0 0 0 0 8
2 0 0 0 3 0 3 3 4 4 4 4 5 5 5 0 0 7 0 0 8 0 0 0 0 8 8 0 0 0 0 8
2 0 2 2 3 0 0 0 4 0 0 0 0 0 0 0 0 7 0 0 8 0 8 0 0 0 0 0 0 8 0 8
2 0 0 0 3 0 3 3 4 0 4 0 5 0 5 0 7 7 7 0 8 0 8 0 0 0 0 0 0 8 0 8
2 2 2 0 3 0 3 0 4 0 4 0 5 0 5 0 0 0 0 0 8 0 0 8 0 0 0 0 8 0 0 8
2 0 2 0 3 0 3 0 0 0 4 0 5 0 5 5 7 7 7 7 8 0 0 0 8 0 0 8 0 0 0 8
2 0 2 0 3 3 3 0 4 0 4 0 5 0 0 0 0 0 0 0 8 0 0 0 0 0 0 0 0 0 0 8
2 0 2 0 0 0 3 0 4 0 4 0 5 5 5 5 7 7 7 0 8 0 0 0 0 0 0 0 0 0 0 8
2 0 2 0 3 3 3 0 4 0 4 0 5 0 0 0 0 0 7 0 8 0 8 0 0 0 0 0 0 8 0 8
2 0 2 0 3 0 0 0 4 4 4 0 5 0 5 5 7 7 7 0 8 0 0 0 0 0 0 0 0 0 0 8
2 0 2 0 3 3 3 3 4 0 4 0 5 0 0 0 0 0 0 0 8 0 8 8 0 0 0 0 8 8 0 8
2 0 2 0 0 0 0 0 4 0 4 0 5 0 5 5 7 7 7 0 8 0 0 0 0 0 0 0 0 0 0 8
2 0 2 2 3 3 3 0 4 0 4 0 5 0 5 0 0 0 0 0 8 0 8 8 8 0 0 8 8 8 0 8
2 0 0 0 3 0 0 0 4 0 0 0 5 0 5 0 7 7 7 0 8 0 0 0 0 0 0 0 0 0 0 8
2 2 2 0 3 3 3 0 4 4 0 4 5 0 5 0 7 0 7 0 8 0 8 8 8 8 8 8 8 8 0 8
0 0 0 0 0 0 0 0 0 0 0 0 0 0 5 0 0 0 7 0 0 0 0 0 0 0 0 0 0 0 0 8
2 2 2 2 3 3 3 3 4 4 4 4 5 5 5 5 7 7 7 7 8 8 8 8 8 8 8 8 8 8 8 8
1 white
2 red
3 yellow
4 green
5 cyan
6 blue
7 indigo
8 grey