16 16
1 1 1 5 5 5 0 0 0 0 0 0 0 0 0 0
2 0 0 0 0 2 0 0 0 0 0 0 0 0 0 0
3 3 0 0 0 5 5 5 5 5 5 5 5 5 5 5
0 3 2 0 0 0 6 6 0 0 0 0 0 0 0 0
0 3 3 0 8 0 0 2 5 5 5 5 5 5 5 5
0 0 3 0 0 0 0 0 6 6 0 0 0 0 0 0
0 0 3 0 0 0 9 0 0 6 6 0 0 0 0 0
0 0 3 3 2 0 0 0 0 0 2 5 5 5 5 5
0 0 0 3 3 3 0 0 0 0 0 6 6 0 0 0
0 0 0 0 0 3 3 2 0 0 0 0 6 6 0 0
0 0 0 0 0 0 3 3 0 0 0 0 0 2 5 5
0 0 0 0 0 0 0 3 0 0 0 0 0 0 6 6
0 0 0 0 0 0 0 3 3 2 0 0 0 0 0 6
0 0 0 0 0 0 0 0 3 3 0 0 7 0 0 2
0 0 0 0 0 0 0 0 0 3 0 0 0 0 0 4
0 0 0 0 0 0 0 0 0 3 2 4 4 4 4 4
1 testWall4
2 yellow
3 red
4 sandBricks32x32
5 indigo
6 white
7 porthole32x32
8 cyan
9 green
